1
3
3333333333333333333333333333333333333333333333333333333333
3333333333333333333333333333333333333333333333333333333333
3333333333333333333333333333333300333333333333333333333333
3000000000000000030000000300000000000030000000000000000003
3300000003330000300000003000000000000033300000000000000003
3333333033333003000000003200000000000000430000000000000003
3333333333333303000000003000000000000000300000000000000003
3333333333333303000000000300000000000000300000000000000003
3333333333333303000000000303300000033003000000000000000003
3000000000000303000000000030033333300330000000000000000003
3000000000003003000000000000000000000000000000000000000003
3000000000333003000000000000000000000000000000000000000003
3000000000300003000000000000000000000000000000000000000003
3000000000300030000000000000000000000000000000000000000003
3000000000303300000000000000000000000000000000000000000003
3000000000303000000000000000000000000000000000000000000003
3000000000303000000000000000000000000000000000000000000003
3000000003303000000000003300000000000000000000000000000003
3000000030003333330000030030000000000000000000000000000003
3000000030000000033000030300000000000000000000000000000003
3000000003000000000333300300000000000000000000000000000003
3000000000333333000000003000000000000000000000000000000003
3000000000000000333333003000000000000000000000000000000003
3000000000000000000003003000000000000000000000000000000003
3000000000000000000003003000000000000000000000000000000003
3000000000033300000003003000000000000000000000000000000003
3000000033300030333330000300000000000000000000000000000003
3000000340000003300000003000000000000000000000000000000003
3000000030000000000000030000000000000000000000000000000003
3000000003333003333000030000000000000000000000000000000003
3000000000000330000330300000000000000000000000000000000003
3000000000000000000030300000000000000000000000000000000003
3000000000000000000030300000000000000000000000000000000003
3000000000000000003330300000000000000000000000000000000003
3000000000000000030000300000000000000000000000000000000003
3000000000000000030033000000000000000000000000000000000003
3000000000000000030033000000000000000000000000000000000003
3000000000000000003003000000000000000000000000000000000003
3000000000000000000330000000000000000000000000000000000003
3000000000000000000000000000000000000000000000000000000003
3000000000000000000000000000000000000000000000000000000003
3333333333333333333333333333333333333333333333333333333333
