8
12
333333333333333
333333333333333
333333333333333
333333333333333
333333333333333
333300000000333
330000020000003
330000000000003
330000000000003
330000000000003
330000000000003
333000000000033
333300000003333
333333333333333
333333333333333
333333333333333
333333333333333
