20
90
0000000000000000000000000000000000000000000000000000300000000000000000000000000000000000000000000000
0330000000000000000000000000000000000000000000000000300000000000000000000000000000000330000000000000
0330000000000000000000000000000000000000000000000000300000000000000000000000000000330330003300000000
0000000330003330000000000000000000000000000000000003000000000000000000000000000000330000003300000000
0003330330003330000003300000330000000000000000000000300000000000000033000000000330333333033333303330
0003330000003330000003300000330000000330000000033000300000000000000033000000000330333333333333333330
0000000000000000000003300000330000000330000000033000300000000000000000000000000033333333333333330000
0000000000000000000000000000000000000330000000033000030000000000000000000000033333333333333333333033
0003300000000000000000000000330000000000000000000000300000000000000000000000033333333333333333333033
0003300000000000000000000000330000000000000000000003000000000000000000000000000333333333333333333300
0000000003300000000000000000330000000000000003300003000000000000000000000000000333333333333333333300
0000000003300000000000000000000000000000000003300030000000000000000000000000033333333333333333333300
0000000000000000000000000000000000000000000003300003000000000000000000000000033333333333333333333300
0003300000000000000000000000000000000000000000000000300000003300000000000000033333333333333333333333
0003300000000000033000000000000000000000000000000000030000003300000000000000000333333333333333333333
0003300000000000033000000000000000000000000000000000030000000000000000000000000333333333333333333300
0000000000003300033000000000000000000000000000000000300000000000000000000000000003333333333333333000
0000000330003300000000000000000000000000000000000000dc0000000000000000000000000033033333333333333000
0000000330003300000003300000000000033000003300000000300000000000000000000000000033003333333000330000
0003300330000000000003300000000000033000003300000000300000000000000000000000000000003333330000330000
0003300000000000000003300000000000033000003300000000300000000000000000000000000000000003300000330000
0003300000000000330000000000000000000000000000000003000000000000000000000000000000000003300000000000
0000003300003300330000000000000000000000000000000033000000000000000000000000000000000000000000000000
0000003300003300330000033000000000000330000000000030000000000000000000000330000000000000000000000000
0000003300003300000000033000000000000330000033000030000000000000000000000330000000000000000000000000
0000000000000000000000033000000000000330000033000003330000000000000000000000000000000000000000000000
0000000000000000000000000000000000000000000033000000003000000000000000000000000000000000000000000000
0003300000000000000000000000000000000000330000000000003000000000000000000000000000000000000000000000
0003300000033333333303300000000000000000330000000000003000000000000000000000000000000000000000000000
0003300000333333333303300000000000000000330000000000330000000000000000000000000000000000000000000000
0000000033333333333303300330000000000000000000000003000000000000033000000333000000000000000000000000
0000000033333333333303330330000000000330003300033030000000000000033000000333000000000000000033000000
0000000033333333333333330330000000000330003300033003000330000000000000000323000000000000000033000000
0000000033333333333333230000000000000330003300033003000330000000000000000000000000000000000000000000
0330000003333333333330000000330000000000000000000333000000000000000000000000000000000000000000000000
0330000003333333333330003300330000000000000330000330300000000000000000000000000003300000000000000000
0330000003333333333330003300330000000000000330000330300000000000000000000000000003300000000000000000
0000003300333333333330003300000000000000000330000003000000000000000000000000000000000000000000000000
0000003300033333000003300000000000000000000000000000300000000000000000000000000000000000000000000000
0000003300000000000003300000000000000000000000000033333000000000000000000000000000000000000000000000
0000000000000000330003300000000033000000000000003300000330000000000000033000000000000000000000000000
0000000000330000330000000000000033000000000000330000330003300000000000033000000000000000000000000000
0000000000330000330000000000000033000000000003000000330000030000000000000000000000000000000000000000
0000000000330000000000000003300000000000000330000000000000003000000000000000000000000000000330000000
000033000000000000003300000330000000000000de00003333003333000300000000000000000000000000000330000000
0000330003300000000033000003300000000000000300003333333333000300000000000000000000000000000000000000
0000330003300003300033000000000033000000003000003333333333000030000000000000000000000000000000000000
0000000003300003300000000330000033000000003000003333333333000030000000000000000000000000000000000000
0000000000000003300000000330000033000000030000003333333333000003000000000000000000000000000000000000
0000000333300000000000300330000300000000030000003333333333000003000000000033000000000000000000000000
000000300003300333300303333000303000333033000000333333333303300333000000330030000003330333c330003333
033303000003333033333000000333000333000303000000333322333303300300333003033003303330003000b003330000
3033300330033033330330000000000000000000030000000000000000000003000003300330000300000000330000000000
0033000330000033000330000000330330033033003000000000000000000033300000000000000000000000330000000000
0000330000000000000000000000330330033033003000000000000000000033300000000000000000000000000000000000
0000333300330000330000000000000000000000000300033000000000000300000000000000000000000000000000000000
0000003300330000330033000000000000330000000300033000033000000300000000033333333333000000000000000000
3303300000000330000033033033000000330330000030000000033000003000000033333333333333333330000000000000
3303300330000330033000033033000330000330330003000000000000030000003333333333333333333333330000000000
0000000330330000033000000000000330000000330000330000000003300000033333333333333333333333333000033000
0330033000330033000000330000000000000000000000003300000333300000333333333333333333333333333300033000
0330033000003333000000330000330000003300003303300033333003300033333333333333333333333333333300000000
0000000000003300000000000033330003303303303303300330300000000333333333333333333333333333333330000000
0330003300330000003300000033000003300003300000000333000000000333333333333333333333333333333330000000
0330003300330033003303300000003300000000000003300003000000003333333333333333333333303333333333000000
0003300000000033000003303300003300000330000003303330003300003333333333333000033300003333333333000000
0003300330033000000000003300000000330330000000003330003300033333333333333000033300033333333333000000
0000033330033000000000000000000000330000330000000030000000033333333333333000032300033333333333300000
0330033003300000330000000000000000000000330000330300000000033333333333333300000000033333333333300000
0330000003303300330000000000000000000033003300330300000000333333333333333300000000003333333333330000
0000000330003300000000000000000000000033003300000030000003333333333333333300000000003333333333330000
0000330330000000000000000000033000000000000000330333300003333333333333333300033000003333333333330000
0000330000000000000000003300033000000000000000330330300003333333333333333333433333333333333333333000
0330000000330000000000003300000033000000330000000000300033333333333333333333333333333333333333333000
0330003300330003300000000000000033000000330330000003000033333333333333333333333333333333333333333000
0000003300000003300000000000000000000000000330000333000033333333333333333333333333333333333333333000
0000000000003300000330000000033000000000000000330330330033333333333333333333333333333333333333333000
0003300000003300000330000000033000033000000000330000030033333333333333333333333333333333333333333000
0003300000000000000000330000000033033000003300000000030033333333333333333333333333333333333333333000
0000000000330000000000330000000033000000003300000330003033333333333333333333333333333333333333333000
0000000000330000000000000000330000000000000003300330003033333333333333333333333333333333333333333000
0330033000000000033300000000330000000000033003300000030033333333333333333333333333333333333333330000
0330033000000000033300000000000000033000033000033303300033333333333333333333343333333333333333330000
0000000000000000000000000000000330033000000000033330000003333333333333333333003333333333333333330000
0000000000000000000000000033000330000000000000032303000003333333333333333333003333333333333333330000
0000000000330000000000000033000000000000000033000003300000333333333333333333003333333333333333300000
033000000033000000000000000003300033000000003300B000300000033333333333333333303333333333333333300033
033000000000000003300000000003300033000330000000000ab00000003333333333333333300333333333333330000033
0000330000000000033000033000000000000333300000000000300000000033333333333333300333333333333300000000
000033000000000000A000033000000000000330000000000000030000000003333333333333300333333333333000000000
0000000003330000000000000003300330000000000000000000030000000003333333333333303333333333300000033000
000000000333000C000D00000003300330000003300000000000330000003300033333333333003333333330000000033000
3300000000000000000003300000000000003303303300000000300000003300000033333333003333333000000333000330
3300330000000000033003300330330000003300003300000330300000000000000000003333003333000000000333000330
0000330033033000033000000330330000330000000003300333003300000000000000000000000000000000000000000000
0000000033033000000000000000000000330033000003300003003300000000000000000000000000330003300000000000
0330000000000033000033033000000330000033003300000000300000000000000000000000000000330003300033000000
0330033000330033033033033003300330000000003300000000030000000003300000000000000000000000000033000000
0000033000330000033000000003300000000000000000000000300000000003300000000000000000000000000000000000
0000000000000000000000000000000000000000000000000000300000000000000000000000000000000000000000000000
